#############################
#                           #
#   ###   ###   ###   #######
#   $ #    #$   #     # $   #
#     #    ######     ##   ##
##    #       #    $   #   ##
###   ####    ######       ##
##     $#     #    #    #####
#      ###    ###  #    #####
#   #####     ###  #    #   #
#    ##     ###    #   ##  $#
#    #      ##     #    #   #
#    #      #      #        #
#    ##           ###     ###
#        $  #              ##
#                          ##
#   ##     ##    ############
#############################